CP = Chest pain
SOB = Shortness of breath 
SOBOE = Shortness of breath on exertion
PT = patient 
C/O = Complains of
N/V = nausea vomiting
N/V/D = nausia vomitting diarrhea
-N-V = no nausia no vomiting
DC = discharge
EMS = emergency medical services
RT/LT = right/left
GI = gastro-intestinal
GU = genitourunary
SI = suicidal ideation
HI = homicidal ideation/intent
HI = head injury 
TPS = Toronto police services
NFA = no fixed address aka homeless
LOC = level/loss of consciousness
LOA = level of alertness
BR = bathroom
BIBA = brought in by ambulance
PMH = past medical history
WIC = walk in clinic
GCS = glasgow coma scale
abdo = abdominal
RUQ = right upper quadrant
LUQ = left upper quadrant
RLQ, LLQ = lower quadrant
US = ultrasound
HR = heartrate
UTI = urinary tract infection
HA = headache
FU = follow up
AKI = acute kidney injury
FLS = flu like symptoms
FLI = flu like illness
D2 = didgit 2
Xd = x days
ED = emergency department
ER = emergency room
NIL = no, or absense of
SBP/DBP = systolic/diastolic blood pressure
VSA = vital signs absent
PEA = pulseless electrical activity
CPR = cardiopulmonary resuscitation
PNA = pnemonia
DX = diagnosis
PTX = pnemothorax
FMD = family doctor
GP = family doctor / general practitioner
IV = intravenous
ABX = antibiotics
SZ = seizure
BG = blood glucose
CG = capillary glucose
LWBS = left without being seen
LAMA = left against medical advice
ETOH = ethanol
HBD = has been drinking
CSM = circulation sensory motion
LSN = last seen normal
W/U = work up
NH = nursing home
LTC = long term care
CT = computer topography 
MRI = magnetic resonance imaging
US = ultrasound
LBM = last bowel movement
TWH = toronto western hospital
TGH = toronto general hospital
CA = cancer
hst = history
pmhx = past medical history
hx = history
OTC = over the counter
MHA = mental health apprehension
HD = hemodialysis
PD = peritoneal dialysis
a+o or A/O = alert and oriented
O2 = oxygen
NTG = nitroglycerine 
PMH = princess margret hospital (sent from, was at)
ROSC = return of spontainious circulation
MSH = mount syanide hospital
CHF = conngestive heart failure
RVH = royal victoria hospital
TMJ = jaw issue
lac = laceration
sx = symptoms OR surgery
R/o = rule out
PE = pulminary embolism
BIL = bilateral
PPM = pacemaker
defib/icd = defibrilator
GIM = general internal medicine
BCP = birth control pill
OCP = oral contreceptive pill
